1111111111111111111111111111111111111111111111111111111111111111111111111111111
1001000C00000000000000000000000011111111111111111111111111111111111111111111111
1000000011000000000000000000000011111111111111111111111111111111111111111111111
1P0000E000000000000000000000000011111111111111111111111111111111111111111111111
10000000000000000000000C0000000011111111111111111111111111111111111111111111111
1000000000000000000000000000000011111111111111111111111111111111111111111111111
10000000000000000000000C0000000011111111111111111111111111111111111111111111111
1000000000000011111110000000000011111111111111111111111111111111111111111111111
1000000000000000000010000000000011111111111111111111111111111111111111111111111
1000000000000000000010000000000011111111111111111111111111111111111111111111111
10000000000000000000100C0000000011111111111111111111111111111111111111111111111
1000000000000000000000000000000011111111111111111111111111111111111111111111111
1111111111111111111111111111111111111111111111111111111111111111111111111111111
