11111111
10000C01
1P0E1001
11111111