11111111111111111111111111111111111
111111111111E111111110CP11111111111
11111111111111111111111111111111111