1111111111111111111111111111111111
1EM000000000000C00000C000000000001
1010010100100000101001000000010101
1010010010101010001001000M00010101
1P0000000C00C00M0M00000000000000C1
1111111111111111111111111111111111